11111111011111111111111011111111
11111111011111111111111011111111
11222211011222211222211011222211
11211211011211211211211011211211
11211222522211211211222522211211
11211121112111211211121112111211
11211121112111211211121112111211
11222222322222211222222322222211
11112111211121111112111211121111
11112111211121111112111211121111
00002222222221111112222222220000
11112111121121111112112111121111
11112111121121111112112111121111
11222111121122211222112111122211
11211113221111211211112231111211
11211112111111211211111121111211
11222112111122211222111121122211
11112112111121111112111121121111
11112222241121111112112222221111
00002111122221111112222111120000
11112111121121111112112111121111
11112111121121111112112111121111
11222222322222211222222322222211
11211121112111211211121112111211
11211121112111211211121112111211
11211222522211211211222522211211
11211211011211211211211011211211
11222211011222211222211011222211
11111111011111111111111011111111
11111111011111111111111011111111
111111111111111-15
