11111111111111111111111111111111
11111111111111111111111111111111
11222222222222211222222222222211
11211151121111211211112115111211
11211121121111211211112112111211
11211121122211211211222112111211
11322221111211211211211112222311
11211121111211222211211112111211
11211121122222211222222112111211
11211121121111211211112112111211
11222221121111211211112112222211
11111121122222211222222112111111
11111121111211111111211112111111
11111121111211111111211112111111
00000022232211224211223222000000
11111121121111211211112112111111
11111121121111211211112112111111
11111121122222211222222112111111
11222221111121111112111112222211
11211121111121111112111112111211
11211132221121111112112223111211
11221121122222211222222112112211
11121121121111211211112112112111
11151121121111211211112112115111
11222221122211211211222112222211
11211111111211211211211111111211
11211111111211211211211111111211
11222222222222222222222222222211
11111111111111111111111111111111
11111111111111111111111111111111
111111111111111-15

