11111111101111111111110111111111
11111111101111111111110111111111
11222222221111111111112222222211
11211211121111111111112111211211
11311211122222222222222111211311
11211211121112111121112111211211
11211211121112111121112111211211
11522222222222111122222222222511
11211111111112111121111111111211
11211111112222222222221111111211
00211111112112111121121111111200
11222111112112111121121111122211
11112222223222111122232222221111
11112111111121111112111111121111
11112111111122222222111111121111
11112111111121111112111111121111
11112222223221111112232222221111
11222111112111111111121111122211
11211111112111111111121111111211
11211111112222242222221111111211
00211111111112111121111111111200
11211111111112111121111111111211
11211111122222222222222111111211
11522222221112111121112222222511
11211111121112111121112111111211
11211111122222222222222111111211
11311111121111111111112111111311
11222222221111111111112222222211
11111111101111111111110111111111
11111111101111111111110111111111
111111111111111-15
