11111110111111111111111101111111
11111110111111222211111101111111
11222222222211211211222222222211
11211111111211211211211111111211
11211111111222211222211111111211
11222221122211211211222112222211
11121123221111211211112232112111
11121121121111211211112112112111
00022221121122224222112112222000
11121121122221111112222112112111
11121122221121111112112222112111
11121112111122222222111121112111
11121115111121111112111151112111
11122222222221111112222222222111
11111111111111111111111111111111
11111111111111223211111111111111
11222222222211211211222222222211
11211111111211211211211111111211
11211111111222211222211111111211
11222221122211211211222112222211
11121123221111211211112232112111
11121121121111211211112112112111
00022221121122222222112112222000
11121121122221111112222112112111
11121122221121111112112222112111
11121112111122222222111121112111
11121115111121111112111151112111
11122222222221111112222222222111
11111110111111111111111101111111
11111110111111111111111101111111
111111111111111-15
